{
    "vehicles" : [
        "UH-18YAA",
        "AT-16ZAA",
        "EB-56EAA",
        "IK-10RMA",
        "IL-83LzA",
        "IJ-63UxA",
        "ES-76IzA",
        "IN-27PuA",
        "EZ-11Y4A",
        "AS-23KCA",
        "AN-19HYA",
        "US-42BFA",
        "FhFixMrx",
        "6BF5KlBV",
        "eL54ArUF",
        "-YA3bfeK7",
        "A7OUKnqR",
        "nVwHWcUE",
        "qJKH6bb4",
        "FHow0bQm",
        "gEF5Fc0t",
        "RGnRCLcO"
    ]
}